const words = `
below = ниже
inputted = введённый
nest = гнездо
wrap = оборачивать
consider = считать
assist = помощь
above = выше
however = тем не менее
few = несколько
overall = в целом
evolve = эволюционировать
major = главный
especially = особенно
the rest of = остальная часть
markup = разметка
in addition = к тому же
various = различные
several = несколько
generic = общий
due to = из-за
implementation = реализация
within = в
benefit = выгода
enforce = применять
widely = широко
unique = уникальный
agreed = согласовано
upon = на
essentially = по существу
rectangle = прямоугольник
surround = окружать
increase = увеличение
distance = расстояние
to match = соответствовать
amount = количество
appear = появиться
entire = всё
clockwise = по часовой стрелке
earn = зарабатывать
exactly = именно так
represent = представлять
either = либо
presence = присутствие
matching = соответствие
designates = обозначает
quotaion = цитирование
indeterminate = неопределённый
relative = относительные
tie = привязаны
respectively = соответственно
measurement = измерение
approximate = приближённый
start fresh = начать заново
prove = доказывать
receive = получать
override = переопределение
subsequent = последующий
belong = принадлежать
precedence = старшинство
regardeless = не смотря на
attach = прикреплять
rather = скорее
typo = опечатка
provide = предоставить
avoid = избежать
recognize = знать
applied = прикладной
overwhelming = подавляющий
wolly = шерстистый
simplicity = простота
skew = скос
crescent = полумесяц
accessibility = доступность
broad = широкий
conclusion = заключение
appropriate = подходящее
melt = плавится
`;